11 17
5 13 13 13 13 13 13 13 13 13 21
6 14 14 14 14 14 14 14 14 14 22
6 14 14 14 14 14 14 14 14 14 22
6 14 14 14 14 14 14 14 14 14 22
6 14 14 14 14 14 14 14 14 14 22
6 14 14 14 14 14 14 14 14 14 22
7 15 15 15 15 30 15 15 15 15 23
0  0  0  0  6 14 22  0  0  0  0
0  0  0  0  6 14 22  0  0  0  0
0  0  0  0  6 14 22  0  0  0  0
5 13 13 13 13 14 13 13 13 13 21
6 14 14 14 14 14 14 14 14 14 22
6 14 14 14 14 14 14 14 14 14 22
6 14 14 14 14 14 14 14 14 14 22
6 14 14 14 14 14 14 14 14 14 22
6 14 14 14 14 14 14 14 14 14 22
7 15 15 15 15 15 15 15 15 15 23
