7 15 15 15 15 15 15 15 15 15 23
6 14 14 14 14 14 14 14 14 14 22
6 14 14 14 14 14 14 14 14 14 22
6 14 14 14 14 14 14 14 14 14 22
6 14 14 14 14 14 14 14 14 14 22
6 14 14 14 14 14 14 14 14 14 22
5 13 13 13 13 29 13 13 13 13 21
0  0  0  0  7 14 23  0  0  0  0
0  0  0  0  6 14 22  0  0  0  0
0  0  0  0  6 14 22  0  0  0  0
7 15 15 15 14 14 14 15 15 15 23
6 14 14 14 14 14 14 14 14 14 22
6 14 14 14 14 14 14 14 14 14 22
6 14 14 14 14 14 14 14 14 14 22
6 14 14 14 14 14 14 14 14 14 22
6 14 14 14 14 14 14 14 14 14 22
5 13 13 13 13 13 13 13 13 13 21
